Generating 'report.txt'
Report date: Wed Mar 22 02:26:16 EDT 2023

When listing languages for a specific program, the language maybe followed
by a special character. Those characters mean the translation file failed
a specific test.

  ? unable to locate default English version
  ! caution, English version is newer than translation
  + caution, has some extras keys and probably nothing to worry about
  * problem, has some missing keys

Also note, this utility does not scan the following directories:

  packages, fdi, htmlhelp

and does not compare 'txt, docinfo, htm, html, inc' file types or subdirectories.


Translation file overview:

append: de, en, es, fr, ptbr, sv, tr (compare 'help' manually)
assign: de, en, es, fr, ptbr, sv, tr (compare 'help' manually)
blkdrop: de, en, fr, tr (compare 'help' manually)
blocek: ?fr, ?tr, ?cz, ?de, ?en, ?ru (compare 'source' manually)
choice: de, dk, en, es, fi, fr, hu*, it, lv*, nl, pl, pt, ru, sl, sv, tr, ptbr (compare 'help' manually)
compute: cz, de, dk, en, es, fr, pl, pt, ru, sl, sv, tr (compare 'nls' manually)
ctmouse: br?, de?, en?, es?, fr?, hu?, it?, lv?, nl?, pl?, pt?, sk?, sv?, tr? (compare 'source' manually)
danger: en, fr, tr (font files)
diskcopy: de, dk, en, es, fi, fr, it!, nl!, pl, sl, sv, tr
display: de, en, es, fr, sv, tr (compare 'source' manually)
doslfn: de, en, es!, fr! (compare 'help, source' manually)
dosutil: de, en, es, fr, ptbr, sv, tr (compare 'help' manually)
edict: de, en, es+, fr, tr
edlin: da, de, en, eo, es, eu, fi, fr, is, it, ja*, la, nl, no, pl, pt, sl, sv, tr
exe2bin: de, en, es, fr, ptbr, sv, tr (compare 'help' manually)
fc: de, dk, en, es, fr, it, lv, nl, pl, sl, sv, tr (compare 'help' manually)
fdhelper: de!, en, es*, fr!, sv!, tr!, eo, nl, es! (compare 'help' manually)
fdi-x86: de, en, es!, fr, sv!, tr
fdimples: de, en, eo*, es*, fr, nl*, ru*, sv, tr
fdisk: de, en, es, fr, ptbr, sv, tr (compare 'help' manually)
fdnet: de, en, es*, fr, sv, tr
fdnpkg: de, dk*, en, es, fr, pl*, si*, sl*, tr
fdpkg: de, en, es, fr, pl, tr
fdshell: de, en, es, fr, ptbr, sv, tr (compare 'help' manually)
fdtui: de, en, es, fr+, no, sv, tr, fr (compare 'doc' manually)
find: de, dk, en, es, fi, fr, hu*, it, lv, nl, pl, pt, ru, sl, sv, tr
flashrom: de, en, es, fr, ptbr, sv, tr (compare 'help' manually)
freecom: ?nl, !en, ?fi, ?fr, ?de, ?it, ?pl, ?pt, ?ptbr, ?ru, !sr, !sl, ?es, ?sv, ?tr, ?uk (compare 'source' manually)
gcdrom: de, en, es, fr, sv, tr (compare 'source' manually)
help-legacy: de, en, es, fr, hu, it, lv*, nl, pl, pt, ru, sl, sv, tr
imgedit: de!, en, es, fr, sv, tr, fr!, sv!, tr! (compare 'help' manually)
keyb: de!, en, es!, fr!, tr! (compare 'source' manually)
kitten: fr?, tr? (compare manually)
kittenc: en, es!, de, fr, sv, tr
label: de, en, fr, no, sv, tr
localize: de, en, es, fr, sv, tr
md5sum: de, en, es, fr, nl*, pl, sv, tr
mem: de, en, es!, fi!, fr!, it*, nl!, pl!, sl!, sv!, tr!
mirror: de, en, fr, sv, tr (compare 'help' manually)
mode: en
more: de, dk, en, eo, es, fi, fr, hu*, it, lv, nl, pl, pt, ru, sl, sv, tr (compare 'help' manually)
move: de, en, eo, es, fr, it, pl, sl, sv, tr
nlsfunc: de, en, fr, sv, tr (compare 'help' manually)
password: de!, en, es!, fr!, pl!, pt!, sv!, tr!
pause: de, dk, en, es, fr, pl, pt, ru, sl, sv, tr
pdtree: de, en, es, fr, sv, tr (compare 'source' manually)
pgme, efntdsgn: de, fr!, tr! (language files only)
